58 58 58 58 58 58 58 58 58 58 12 12 12 12 12 12 12 12 19 19 19 12 12 12 12 12 12 12 12 12 12 71
58 58 58 58 58 58 58 58 71 58 12 12 12 12 12 71 12 12 19 19 19 12 12 12 12 12 12 12 12 12 12 71
58 58 58 58 58 58 58 58 58 58 12 12 12 12 12 12 12 12 19 19 19 19 19 19 12 12 12 12 12 12 12 12
58 71 58 58 58 58 58 58 58 58 12 12 12 12 12 12 12 12 19 19 19 19 19 19 12 12 12 12 12 12 12 12
58 58 58 58 58 58 58 58 58 58 12 12 12 12 12 12 12 12 19 19 19 19 19 19 12 12 12 12 12 12 12 12
58 58 58 58 58 58 58 58 58 58 12 12 12 12 12 12 12 12 12 12 12 19 19 19 12 12 12 12 12 12 12 12
58 58 58 58 58 58 58 58 58 58 12 12 12 12 12 12 12 12 12 12 12 19 19 19 12 12 12 12 12 12 12 12
58 58 58 58 58 58 58 58 58 58 12 12 12 12 12 12 12 12 12 12 19 19 19 19 12 12 12 12 12 12 12 12
58 58 58 58 58 58 58 58 58 58 12 12 12 12 12 12 12 12 12 12 19 71 19 19 12 12 12 12 12 12 12 12
58 58 58 58 58 58 58 58 58 58 12 12 12 12 12 12 12 12 12 12 12 19 19 19 12 12 12 12 12 12 12 12
58 58 58 58 58 58 58 58 58 58 12 12 12 12 12 71 12 12 19 12 12 19 12 19 12 12 12 12 12 12 12 12
58 58 58 58 58 58 58 58 58 58 12 12 12 12 12 12 19 12 12 12 12 19 19 19 12 12 12 12 12 12 12 12
12 71 12 12 12 12 12 12 12 12 12 12 12 12 12 12 12 12 12 12 12 19 19 19 12 12 12 12 12 12 12 12
12 12 12 12 12 12 12 12 12 12 12 12 12 12 12 12 12 12 12 12 12 71 19 19 12 12 12 12 12 12 12 12
12 12 12 12 12 12 12 12 12 12 12 12 12 12 12 12 12 12 12 12 71 19 19 71 12 12 12 12 12 12 12 12
12 12 12 12 12 12 12 12 12 12 12 12 12 12 12 12 12 12 12 19 19 19 19 19 12 12 12 12 12 12 12 12
12 12 12 12 12 12 12 12 12 12 12 12 12 12 12 12 12 12 12 19 19 71 12 12 12 12 12 12 12 12 12 12
12 12 12 12 12 12 12 12 12 12 12 12 12 12 12 12 12 12 12 19 19 19 12 12 12 12 12 12 12 12 12 12
12 12 12 12 12 12 12 12 12 12 12 12 12 12 12 12 12 12 12 19 19 19 12 12 12 12 12 12 12 12 12 12
12 12 12 12 12 12 12 12 12 12 12 12 12 12 12 12 12 12 12 19 19 19 12 12 12 12 12 12 19 12 12 12
12 12 12 12 12 12 12 12 12 12 12 12 12 12 12 12 12 12 12 19 19 19 12 12 12 12 12 12 12 12 12 12
12 12 12 12 12 12 12 12 12 12 12 12 12 12 12 12 12 12 12 19 19 19 12 12 12 12 12 12 12 12 12 12
12 12 12 12 12 12 12 12 12 12 12 12 12 12 12 12 12 12 12 19 19 19 19 19 19 19 12 12 12 12 12 12
12 12 12 12 12 12 12 12 12 12 12 12 12 12 12 12 12 12 12 19 19 19 19 19 19 19 12 12 12 12 12 12

150 150 150 150 150 150 150 150 150 150 107 107 107 107 107 107 107 107 107 103 107 107 104 109 104 109 109 109 109 109 109 -1
150 -1 -1 -1 -1 -1 -1 -1 -1 150 -1 -1 -1 107 104 -1 107 126 107 103 104 -1 -1 109 -1 -1 -1 -1 109 -1 109 -1
150 -1 -1 -1 -1 -1 -1 -1 -1 150 -1 107 -1 107 -1 -1 107 112 107 103 107 107 -1 -1 109 109 109 -1 -1 -1 109 109
150 -1 -1 -1 -1 -1 -1 -1 -1 150 -1 107 -1 107 -1 107 107 112 107 95 118 118 100 -1 -1 -1 109 -1 109 -1 -1 122
150 150 -1 150 150 150 -1 150 150 150 107 107 -1 107 -1 107 -1 112 104 107 107 107 103 107 -1 -1 109 -1 115 115 115 109
-1 150 120 110 110 110 110 110 110 110 110 110 110 110 114 107 101 98 114 107 -1 107 103 107 107 -1 109 -1 -1 -1 115 115
150 150 150 -1 150 -1 150 150 150 -1 107 107 107 107 134 110 127 107 134 110 110 140 139 143 110 110 114 -1 115 -1 -1 115
150 -1 -1 -1 150 -1 150 -1 -1 -1 107 104 -1 -1 -1 -1 112 -1 107 107 107 107 103 107 -1 107 112 109 109 -1 115 109
150 -1 150 150 150 -1 150 150 150 -1 107 -1 -1 107 -1 107 134 110 110 110 114 -1 103 107 -1 107 112 109 -1 101 110 110
150 -1 150 -1 -1 -1 -1 -1 150 -1 107 -1 107 -1 -1 107 -1 107 -1 107 112 107 103 107 107 107 112 109 109 112 109 109
150 -1 -1 -1 150 150 150 -1 150 -1 107 -1 107 -1 107 -1 -1 -1 104 107 116 140 139 143 110 110 98 110 110 127 109 -1
150 150 -1 150 150 -1 -1 -1 107 -1 107 -1 -1 -1 -1 107 104 -1 -1 -1 112 107 103 107 107 107 109 109 109 112 107 -1
107 -1 -1 107 -1 -1 107 107 107 -1 107 -1 107 107 -1 -1 107 107 -1 107 112 104 103 107 -1 107 -1 -1 101 102 109 -1
107 107 -1 107 -1 107 107 -1 -1 -1 -1 -1 107 104 107 -1 -1 107 101 110 102 -1 103 107 -1 -1 109 109 112 109 109 109
107 -1 -1 -1 -1 -1 -1 -1 107 -1 107 107 107 -1 -1 104 -1 -1 112 -1 -1 128 129 -1 107 -1 -1 -1 116 110 110 110
107 107 107 -1 107 107 107 107 107 -1 -1 -1 -1 -1 -1 -1 107 -1 112 104 128 129 107 -1 -1 107 109 109 112 109 -1 109
-1 -1 107 -1 107 -1 -1 -1 -1 -1 142 -1 107 107 107 -1 -1 107 112 -1 103 -1 -1 107 -1 -1 -1 109 112 -1 -1 109
107 107 107 -1 107 -1 107 -1 107 -1 -1 -1 107 -1 -1 107 -1 -1 112 115 103 107 -1 107 107 107 -1 109 112 109 109 109
107 -1 -1 -1 -1 -1 107 -1 107 -1 107 -1 -1 107 -1 -1 107 101 102 -1 103 -1 -1 -1 -1 -1 -1 109 116 110 110 110
107 107 107 -1 107 107 107 -1 -1 -1 -1 107 -1 -1 107 -1 -1 112 148 107 103 107 107 -1 107 -1 109 109 112 109 109 109
107 -1 -1 -1 -1 -1 -1 -1 -1 107 -1 -1 107 -1 -1 107 -1 134 110 140 139 143 114 107 107 -1 109 109 112 -1 -1 109
107 -1 107 -1 107 -1 107 107 107 -1 107 -1 -1 107 -1 -1 -1 107 -1 -1 103 107 134 110 110 110 114 109 112 109 109 109
107 -1 107 -1 107 -1 -1 -1 -1 -1 -1 -1 -1 -1 -1 107 -1 -1 -1 -1 119 118 118 118 100 107 134 110 98 110 96 109
107 107 107 107 107 107 107 107 107 107 107 107 107 107 107 107 107 107 107 122 103 -1 -1 107 103 -1 109 109 109 109 109 109
