12 12 12 12 12 12 12 19 19 19 58 58 58 12 58 58 58 12 19 19 19 80 21 21 21 6 91 31 28 28 28 28
12 58 58 58 58 58 58 19 19 19 58 58 58 58 58 58 58 58 19 19 19 80 21 21 21 6 6 32 28 28 28 28
12 58 12 12 58 12 58 19 19 19 58 58 58 58 58 58 58 58 19 19 19 80 21 21 21 39 91 31 28 28 28 28
12 58 12 58 58 12 58 19 19 19 58 58 58 58 58 58 58 58 19 19 19 80 21 21 21 6 91 31 28 28 28 28
12 58 12 12 12 12 58 19 19 19 58 58 58 58 58 58 58 58 19 19 19 80 21 21 21 6 91 31 28 28 28 28
12 58 58 58 58 58 58 19 19 19 58 58 58 58 58 58 58 58 19 19 19 80 21 21 21 6 91 31 28 28 28 28
19 19 19 19 19 19 19 19 19 19 19 19 19 19 19 19 19 19 19 19 19 80 21 21 6 6 91 31 28 28 28 28
19 19 19 19 19 19 19 19 19 19 19 19 19 19 19 19 19 19 19 19 19 53 50 50 50 50 67 62 40 20 28 28
19 19 19 19 19 19 19 19 19 19 19 19 19 19 19 19 19 19 19 19 19 58 58 58 58 58 58 58 58 31 28 28
12 12 12 12 12 12 12 12 12 12 12 12 12 12 12 12 12 12 12 12 12 12 12 12 12 12 12 58 58 31 28 28
12 12 12 12 12 12 12 12 12 12 12 12 12 12 12 12 12 12 12 12 12 12 12 12 12 12 12 58 58 31 28 28
12 12 12 12 12 12 12 12 12 12 12 12 12 12 12 12 12 12 12 12 12 12 12 12 12 12 12 58 58 31 28 28
12 12 12 12 12 12 12 12 12 12 12 12 12 12 12 58 58 58 58 58 58 58 58 58 58 58 58 58 58 31 28 28
12 12 12 12 12 12 12 12 12 12 12 12 12 12 12 58 15 15 15 15 58 71 71 71 58 58 58 58 58 31 28 28
12 12 12 12 12 12 12 12 12 12 12 12 12 12 12 58 15 15 15 15 58 71 71 71 52 54 65 51 73 33 28 28
12 12 12 12 12 12 12 12 12 12 12 12 12 12 58 58 15 15 15 15 58 71 71 71 80 21 91 31 28 28 28 28
12 12 12 12 12 12 12 12 12 12 12 12 12 12 12 58 15 15 15 15 58 71 71 71 80 21 91 31 28 28 28 28
12 12 12 12 12 12 12 12 12 12 12 12 12 12 12 58 15 15 15 15 58 71 71 71 53 50 67 31 28 28 28 28
12 12 12 12 12 12 12 12 12 12 12 12 12 58 58 58 58 58 58 58 58 58 58 58 58 58 58 32 28 28 28 28
12 12 12 12 12 12 12 12 12 12 12 12 12 58 22 22 22 22 58 58 58 58 52 54 54 54 65 31 28 28 28 28
12 12 12 12 12 12 12 12 12 12 12 12 12 58 22 22 22 22 58 58 58 58 80 21 21 21 91 31 28 28 28 28
12 12 12 12 12 12 12 12 12 12 12 12 12 58 22 22 22 22 58 58 58 58 80 21 21 21 91 31 28 28 28 28
12 12 12 12 12 12 12 12 12 12 12 12 12 58 22 22 22 22 58 58 58 58 80 21 21 21 91 31 28 28 28 28
12 12 12 12 12 12 12 12 12 12 12 12 12 58 22 22 22 22 58 58 58 58 80 21 21 21 91 31 28 28 28 28

107 107 107 107 107 132 132 104 103 -1 132 132 132 132 132 132 -1 132 132 132 132 106 106 106 106 106 106 -1 -1 -1 -1 -1
107 -1 -1 -1 -1 -1 -1 -1 103 -1 104 -1 -1 -1 141 -1 -1 -1 -1 128 118 118 118 118 118 118 118 -1 -1 -1 -1 -1
107 -1 132 132 -1 132 -1 -1 103 -1 -1 -1 -1 -1 126 -1 -1 -1 -1 103 104 -1 106 106 106 -1 106 -1 -1 -1 -1 -1
107 -1 132 -1 -1 132 -1 -1 103 -1 -1 -1 -1 142 112 142 -1 -1 -1 103 -1 -1 -1 -1 -1 -1 106 -1 -1 -1 -1 -1
107 -1 132 132 132 132 -1 -1 103 -1 -1 -1 -1 -1 112 -1 -1 -1 -1 103 -1 -1 106 106 106 -1 106 -1 -1 -1 -1 -1
107 -1 -1 -1 -1 -1 -1 -1 103 -1 138 -1 -1 -1 112 -1 -1 138 -1 103 -1 -1 106 -1 106 -1 106 -1 -1 -1 -1 -1
-1 151 -1 -1 -1 -1 -1 104 103 104 -1 -1 -1 -1 151 -1 -1 -1 -1 103 -1 -1 -1 -1 -1 -1 106 -1 -1 -1 -1 -1
118 149 118 118 118 118 118 118 145 118 118 118 118 118 149 118 118 118 118 129 104 106 106 106 -1 106 106 -1 -1 -1 -1 -1
-1 153 -1 -1 -1 -1 -1 -1 -1 -1 -1 -1 -1 -1 153 -1 -1 -1 -1 -1 -1 -1 -1 -1 -1 -1 -1 -1 104 -1 -1 -1
115 112 -1 -1 115 115 -1 115 -1 115 -1 115 -1 115 112 115 115 -1 -1 115 115 -1 115 115 115 115 -1 -1 138 -1 -1 -1
115 112 115 115 115 -1 115 -1 115 -1 115 -1 115 -1 112 -1 -1 -1 -1 -1 -1 -1 -1 -1 -1 -1 -1 -1 104 -1 -1 -1
115 112 -1 -1 -1 -1 115 -1 115 -1 115 -1 115 -1 112 115 115 -1 -1 115 115 -1 115 115 115 115 -1 -1 104 -1 -1 -1
115 112 115 115 115 -1 -1 -1 -1 -1 -1 -1 -1 115 112 -1 -1 -1 -1 -1 -1 -1 -1 -1 -1 -1 -1 -1 138 -1 -1 -1
148 112 -1 -1 115 -1 -1 126 126 126 126 126 -1 115 112 -1 -1 -1 -1 -1 -1 -1 -1 -1 -1 -1 -1 -1 104 -1 -1 -1
110 98 110 110 114 -1 120 121 121 121 121 127 -1 115 112 -1 -1 -1 -1 -1 -1 -1 -1 -1 -1 -1 -1 -1 -1 -1 -1 -1
107 -1 -1 148 112 -1 120 121 121 121 121 127 -1 -1 112 -1 -1 -1 -1 -1 -1 -1 -1 -1 -1 -1 -1 -1 -1 -1 -1 -1
107 107 107 -1 112 142 120 121 121 121 121 127 142 148 112 -1 -1 -1 -1 -1 -1 -1 -1 -1 -1 -1 115 -1 -1 -1 -1 -1
107 -1 -1 -1 116 110 110 98 98 98 98 98 110 110 102 -1 -1 -1 -1 -1 151 -1 -1 -1 -1 115 115 -1 -1 -1 -1 -1
107 107 107 -1 112 -1 -1 -1 -1 -1 -1 -1 115 128 118 118 118 118 118 118 149 118 118 118 118 118 118 -1 -1 -1 -1 -1
107 -1 107 -1 112 -1 146 115 115 115 115 -1 115 103 -1 -1 -1 -1 -1 141 153 141 141 141 141 141 138 -1 -1 -1 -1 -1
107 -1 107 -1 112 -1 -1 -1 -1 -1 115 -1 115 103 -1 -1 -1 -1 -1 -1 -1 -1 -1 -1 -1 -1 138 -1 -1 -1 -1 -1
107 -1 -1 -1 112 -1 115 115 115 115 115 -1 115 103 -1 -1 -1 -1 -1 141 -1 141 141 141 141 -1 -1 -1 -1 -1 -1 -1
107 -1 107 -1 112 -1 -1 -1 -1 -1 -1 -1 115 103 -1 -1 -1 -1 -1 -1 -1 -1 -1 -1 -1 -1 -1 -1 -1 -1 -1 -1
107 107 107 107 112 107 115 115 115 115 115 115 115 103 -1 -1 -1 -1 -1 141 141 141 141 141 141 141 108 -1 -1 -1 -1 -1
