12 12 12 19 19 19 12 12 12 12 12 12 12 12 12 12 12 12 12 12 12 12 12 12 12 12 12 12 12 12 12 12
12 12 12 19 19 19 12 12 12 12 12 12 12 12 12 12 12 12 12 12 12 12 12 12 12 12 12 12 12 12 12 12
12 12 12 19 19 19 12 12 12 12 12 12 12 12 12 12 12 12 12 12 12 12 12 12 12 12 12 12 12 12 12 12
12 12 12 19 19 19 19 19 19 19 19 19 12 12 12 12 12 12 12 12 12 12 12 12 12 12 12 12 12 12 12 12
12 12 12 19 19 19 19 19 19 19 19 19 12 12 12 12 12 12 12 12 12 12 12 12 12 12 12 12 12 12 12 12
12 12 12 19 19 19 19 19 19 19 19 19 12 12 12 12 12 12 12 12 12 12 12 12 12 12 12 12 12 12 12 12
12 12 12 12 12 12 12 12 12 19 19 19 12 12 12 12 12 12 12 12 12 12 12 12 12 12 12 12 12 12 12 12
12 12 12 12 12 12 12 12 12 19 19 19 12 12 12 12 12 12 12 12 12 12 12 12 12 12 12 12 12 12 12 12
12 12 12 12 12 12 12 12 12 19 19 19 12 12 12 12 12 12 12 12 12 12 12 12 12 12 12 12 12 12 12 12
12 12 12 12 12 12 12 12 12 19 19 19 12 12 12 12 12 12 12 12 12 12 12 12 12 12 12 12 12 12 12 12
12 12 12 12 12 12 12 12 12 19 19 19 19 12 12 12 12 12 12 12 12 12 12 12 12 12 12 12 12 12 12 12
12 12 12 12 12 12 12 12 12 19 19 19 19 12 12 12 12 12 12 12 12 12 12 12 12 12 12 12 12 12 12 12
12 12 12 12 12 12 12 12 12 19 19 19 19 58 58 58 58 58 58 58 58 58 58 58 58 58 58 58 58 58 58 58
12 12 12 12 12 12 12 12 12 12 19 19 19 19 19 19 19 19 19 19 19 19 58 58 58 58 58 58 58 58 58 58
12 12 12 12 12 12 12 12 12 12 19 19 19 19 19 19 19 19 19 19 19 19 52 54 54 54 65 51 73 58 73 73
12 12 12 12 12 12 12 12 12 12 19 19 19 19 19 19 19 19 19 19 19 19 80 21 21 21 91 31 86 58 40 20
12 12 12 12 12 12 12 12 12 12 19 19 19 58 58 58 58 58 58 19 19 19 80 21 21 21 91 31 87 58 58 31
12 12 12 12 12 12 12 12 12 12 19 19 19 58 58 58 58 58 58 19 19 19 80 21 21 21 91 31 87 58 58 31
12 12 12 12 12 12 12 12 12 12 19 19 19 58 58 58 58 58 58 19 19 19 80 21 21 21 36 32 87 58 58 31
12 12 12 12 12 12 12 12 12 12 19 19 19 58 58 58 58 58 58 19 19 19 80 21 21 21 91 31 87 58 58 31
12 12 12 12 12 12 12 19 19 19 19 19 19 58 58 58 58 58 58 58 58 58 80 21 21 21 91 31 87 58 58 31
12 12 12 12 12 12 12 19 19 19 19 19 19 58 58 58 58 58 58 58 58 58 80 21 21 39 91 31 87 58 58 31
12 12 12 12 12 12 12 19 19 19 19 19 19 58 58 58 58 58 58 58 58 58 80 21 21 21 91 31 89 73 73 33
12 12 12 12 12 12 12 19 19 19 58 58 58 58 58 58 58 58 58 58 58 58 80 21 21 21 91 31 28 28 28 28

137 137 137 -1 103 -1 137 137 137 107 137 137 137 107 137 137 137 137 107 137 137 137 132 137 137 137 -1 137 137 137 132 137
137 -1 -1 -1 103 -1 104 -1 -1 -1 -1 -1 -1 -1 -1 -1 -1 -1 -1 137 -1 137 -1 137 -1 137 -1 137 -1 -1 -1 137
137 -1 101 140 139 143 110 110 110 110 110 110 110 110 110 110 110 110 114 137 -1 -1 -1 -1 -1 137 137 132 -1 137 -1 137
137 -1 112 -1 103 -1 -1 -1 -1 -1 -1 -1 137 -1 137 137 137 137 112 137 137 107 137 137 -1 -1 -1 -1 -1 -1 -1 137
137 -1 112 -1 95 118 118 118 118 118 100 -1 137 -1 -1 -1 -1 137 112 137 -1 -1 -1 137 -1 109 137 -1 137 -1 137 137
137 -1 112 -1 -1 -1 -1 -1 -1 -1 103 -1 137 -1 137 109 -1 137 112 137 -1 137 -1 -1 -1 137 -1 -1 137 -1 137 137
109 -1 112 104 137 137 -1 -1 104 -1 103 -1 137 -1 -1 -1 -1 137 112 137 -1 107 137 -1 137 137 -1 137 -1 -1 -1 137
109 104 112 -1 -1 -1 -1 -1 -1 -1 103 -1 137 109 -1 137 137 137 112 137 -1 -1 -1 -1 -1 -1 -1 107 -1 137 -1 137
110 110 102 137 137 137 137 137 137 -1 103 -1 137 -1 -1 -1 -1 137 112 137 137 137 137 137 -1 137 137 137 137 137 137 137
107 -1 -1 -1 -1 -1 -1 -1 137 -1 103 -1 137 137 -1 137 137 109 134 110 110 110 110 110 110 110 110 110 110 114 132 137
107 -1 -1 137 -1 -1 -1 -1 137 -1 103 -1 -1 122 -1 -1 -1 -1 -1 137 -1 -1 -1 -1 -1 -1 -1 -1 137 112 -1 137
107 -1 -1 137 -1 -1 -1 -1 137 -1 95 100 -1 137 137 137 109 137 137 137 137 137 137 137 -1 137 137 137 137 112 137 137
107 -1 -1 137 -1 -1 -1 -1 137 104 -1 103 -1 -1 -1 -1 -1 -1 -1 -1 -1 -1 -1 -1 -1 -1 -1 -1 -1 112 -1 -1
107 -1 -1 137 137 137 137 137 137 -1 -1 103 -1 -1 -1 -1 -1 -1 -1 -1 -1 -1 -1 106 -1 106 -1 -1 -1 151 -1 -1
110 110 110 110 114 -1 -1 -1 122 -1 -1 119 118 118 118 118 118 118 118 118 100 -1 -1 -1 -1 106 -1 -1 -1 149 -1 -1
122 104 -1 104 112 -1 137 137 137 -1 -1 103 -1 -1 -1 -1 -1 -1 -1 -1 103 -1 -1 147 -1 147 -1 -1 -1 149 -1 -1
122 -1 -1 -1 112 -1 -1 -1 -1 -1 -1 103 -1 -1 -1 -1 -1 -1 104 -1 103 -1 106 147 -1 147 106 -1 -1 153 141 -1
122 -1 -1 104 116 110 110 110 110 140 139 139 139 143 -1 -1 -1 -1 -1 -1 103 -1 106 -1 -1 -1 -1 -1 -1 -1 -1 -1
110 110 110 110 102 -1 -1 -1 -1 -1 -1 103 -1 -1 -1 -1 -1 -1 -1 -1 95 118 118 118 118 118 -1 -1 -1 -1 -1 -1
104 137 137 -1 122 137 137 -1 -1 104 -1 103 -1 -1 -1 -1 -1 -1 -1 -1 -1 -1 147 -1 -1 -1 147 -1 -1 -1 -1 -1
137 -1 -1 -1 -1 -1 -1 -1 -1 -1 -1 103 -1 -1 -1 -1 142 -1 -1 -1 -1 106 147 -1 147 147 147 -1 -1 -1 -1 -1
137 -1 137 122 137 -1 137 -1 128 118 118 129 -1 -1 -1 -1 -1 -1 -1 -1 -1 -1 -1 -1 108 -1 147 -1 -1 -1 -1 -1
122 -1 -1 -1 -1 -1 -1 -1 103 -1 -1 -1 -1 -1 -1 -1 -1 -1 -1 -1 -1 -1 106 -1 -1 -1 147 -1 -1 -1 -1 -1
137 137 137 122 137 137 104 -1 103 -1 104 124 124 124 124 124 -1 124 124 124 124 106 106 147 147 147 147 -1 -1 -1 -1 -1
